10000000000000000000
20000000000000000000
30000000000000000000
10000000000000000000
10000000000000000000
60000000000000000000
70000000000000000000
60000000000000000000
90000000000000000000
10000000000000000000