10000000000000000001
20000000000000000001
30000000000000000001
11100000000000000001
10000000000000000001
60000000000000000001
70000000000000000001
60000000000000000001
90000000000000000001
10000000000000000001